XXXXXXXXXXXXXXXXXXXXXXXXXXXX
XNOOOONOOOOONXXNOOOOONOOOONX
XOXXXXOXXXXXOXXOXXXXXOXXXXOX
XOXXXXOXXXXXOXXOXXXXXOXXXXOX
XNOOOONOONOONOONOONOONOOOONX
XOXXXXOXXOXXXXXXXXOXXOXXXXOX
XOXXXXOXXOXXXXXXXXOXXOXXXXOX
XNOOOONXXNOONXXNOONXXNOOOONX
XXXXXXOXXXXX XX XXXXXOXXXXXX
     XOXXXXX XX XXXXXOX     
     XOXXXXX XX XXXXXOX     
     XOXXN  N  N  NXXOX     
XXXXXXOXX XXXXXXXX XXOXXXXXX
     XN  NX      XN  NX     
XXXXXXOXX X      X XXOXXXXXX
     XOXX XXXXXXXX XXOX     
     XOXXN        NXXOX     
     XOXX XXXXXXXX XXOX     
XXXXXXOXXOXXXXXXXXOXXOXXXXXX
XNOOOONOONOONXXNOONOONOOOONX
XOXXXXOXXXXXOXXOXXXXXOXXXXOX
XOXXXXOXXXXXOXXOXXXXXOXXXXOX
XNONXXNOOOOONOONOONOONXXNONX
XXXOXXOXXOXXXXXXXXOXXOXXOXXX
XXXOXXOXXOXXXXXXXXOXXOXXOXXX
XNONOONXXNOONXXNOONXXNOONONX
XOXXXXXXXXXXOXXOXXXXXXXXXXOX
XOXXXXXXXXXXOXXOXXXXXXXXXXOX
XNOOOOOOOOOONOONOOOOOOOOOONX
XXXXXXXXXXXXXXXXXXXXXXXXXXXX
