XXXXXXXXXXXXXXXXXXXXXXXXXXXX
XNOOOONOOOOONXXNOOOOONOOOONX
XOXXXXOXXXXXOXXOXXXXXOXXXXOX
XOXXXXOXXXXXOXXOXXXXXOXXXXOX
XNOOOONOONOONOONOONOONOOOONX
XOXXXXOXXOXXXXXXXXOXXOXXXXOX
XOXXXXOXXOXXXXXXXXOXXOXXXXOX
XNOOOONXXNOONXXNOONXXNOOOONX
XXXXXXOXXXXX XX XXXXXOXXXXXX
     XOXXXXX XX XXXXXOX     
     XOXXXXX XX XXXXXOX     
     XOXXN  S  N  NXXOX     
XXXXXXOXX XXXXXXXX XXOXXXXXX
     XN  pX P  B Xb  NX     
XXXXXXOXX X I  C X XXOXXXXXX
     XOXX XXXXXXXX XXOX     
     XOXXi        cXXOX     
     XOXX XXXXXXXX XXOX     
XXXXXXOXX XXXXXXXX XXOXXXXXX
XNOOOONOONOONXXNOONOONOOOONX
XOXXXXOXXXXXOXXOXXXXXOXXXXOX
XOXXXXOXXXXXOXXOXXXXXOXXXXOX
XNONXXNOONOONOONOONOONXXNONX
XXXOXXOXXOXXXXXXXXOXXOXXOXXX
XXXOXXOXXOXXXXXXXXOXXOXXOXXX
XNONOONXXNOONXXNOONXXNOONONX
XOXXXXXXXXXXOXXOXXXXXXXXXXOX
XOXXXXXXXXXXOXXOXXXXXXXXXXOX
XNOOOOOOOOOONOONOOOOOOOOOONX
XXXXXXXXXXXXXXXXXXXXXXXXXXXX
