XXXXXXXXXXXXXXXXXXXXXXXXXXXX
XNOOOM M M MOOOMOOOOOM    MX
XOXXX XNONX XXX XXXXX XXXX X
XOXKONXXXOX XNOMONXM MX  X X
XOXXXOXNXNX XXX XOXM MXXXX X
XOXNONXOXXX ONX XOX XOXNNX X
XOXXX XNONX XXX XOX XOX  X X
XNOOOMMNXNOMM  MON MXNNNNONX
XXXXXXOXXXXXOXX XXXXKXOXXXOX
XKXNOONXNOOONOOMXXXXOXNXNONX
XOXOXXOXOXXXXXX XNNONXXXOXXX
XNONOONONOOOM  MXXOXOXXXOXXX
XOXXXXXXNXXX XX XXNONOOONONX
XN    NXXXXX XX XXXXXXXXNXOX
XOXXXXNO    M  M    NONXXXOX
XOXXXXOXXXXXM SMXXXXOXNOOONX
XN    NXNNOOM  MOONONXXXXXOX
XOXXXXXXXOXX XX XXOXOXNOOONX
XNONOOONXOXX XX XXOXOXOXXXOX
XXXOXXXNONKX XXMOONXKXOXNONX
XNONXNXXXXXX XX XXOXXXOXOXOX
XOXXXOXXXXXX XX XXNOOONXOXOX
XOXNONNOOOOOMMMMXXOXXXXXOXOX
XOXXXXOXXXXXX  XXXOXXXXXNONX
XN    N   M  MM  MNOOONX X X
XOXXXXOXXX XXUUXX XXXXNOMX X
XOXXXXNOOONXPUUBX XXXXOX X X
XNOONXNXXXOXIUUCX XKXNNXNONX
XOXXOXXXKXOXXXXXX XOXXXX X X
XNNXNOOONXN      MXNOOOOM MX
XXXXXXXXXXXXXXXXXXXXXXXXXXXX