XXXXXXXXXXXXXXXXXXXXXXXXXXXX
XNOOOONOOOOONXXNOOOOONOOOONX
XOXXXXOXXXXXOXXOXXXXXOXXXXOX
XKXXXXOXXXXXOXXOXXXXXOXXXXKX
XOXXXXOXXXXXOXXOXXXXXOXXXXOX
XNOOOONOONOONOONOONOONOOOONX
XOXXXXOXXOXXXXXXXXOXXOXXXXOX
XOXXXXOXXOXXXXXXXXOXXOXXXXOX
XNOOOONXXNOONXXNOONXXNOOOONX
XXXXXXOXXXXX XX XXXXXOXXXXXX
     XOXXXXX XX XXXXXOX     
     XOXXXXX XX XXXXXOX     
     XOXXM  M  M  MXXOX     
     XOXX XXXUUXXX XXOX     
     XN  MXXPUUBXXM  NX     
     XOXX XXIUUCXX XXOX     
     XOXX XXXXXXXX XXOX     
     XOXXM   S    MXXOX     
     XOXX XXXXXXXX XXOX     
XXXXXXOXX XXXXXXXX XXOXXXXXX
XNOOOONOONOONXXNOONOONOOOONX
XOXXXXOXXXXXOXXOXXXXXOXXXXOX
XOXXXXOXXXXXOXXOXXXXXOXXXXOX
XKONXXNOONOONOONOONOONXXNOKX
XXXOXXOXXOXXXXXXXXOXXOXXOXXX
XXXOXXOXXOXXXXXXXXOXXOXXOXXX
XNONOONXXNOONXXNOONXXNOONONX
XOXXXXXXXXXXOXXOXXXXXXXXXXOX
XOXXXXXXXXXXOXXOXXXXXXXXXXOX
XNOOOOOOOOOONOONOOOOOOOOOONX
XXXXXXXXXXXXXXXXXXXXXXXXXXXX
